   $                     H
HXX#XXH          $       H
H     H    H########H $  H
H $ & H    H        H###VH
H#X#X#H    H        H    |
H     H----H-----  &H    |
H     H    H    H###XXXXXH
H     H    H $  H        H
H   & H $  H####H        H
X###X##X##XH        H##H##
X###X      H        H  H  
X$  X      H  ------H  H $
########H###XXX     H ####
        H           H     
        H   @       H     
##########################