                         |
---------   $            |
H$      H#########H      |
####H   H         HXXXXXXX
    H & H    $    H       
    H#####H#####H##       
 $  H     H     H  --     
###H#     H  &  H    --   
   H    H#####H##      --$
   H----H     H  &       #
   H      H#########H     
   H      H#########H     
##H#########   $   #####H#
##H######### H###H #####H#
  H      @   H###H      H 
##########################