          |    |          
          |    |          
   $    H#|    |#H  &     
H#####H-H#|    |#H-H#####H
H#   #H  #|    |#  H#   #H
H#   #H  #|    |#  H#   #H
H# $ #H  #|    |#  H# $ #H
H#####H  #|    |#  H#####H
H#   #H  #|    |#  H#   #H
H#   #H--#H####H#--H#   #H
H#   #  H#H    H#H  #   #H
H#&$ #  H#H  $&H#H  # $&#H
H##V##  HXXXXXXX#H  ##V##H
H     V H        H V     H
H      VH&   @   HV      H
##########################