      $    $          H   
H###############H     H   
H            $  H-----H  $
#########H#######     H###
########HH            H   
#######HH------H      H   
#$ $##HH     & H $  & H  $
#####HH    H####XX####H###
     H     H          H   
     H     H          H   
    &H   $ H----------H  $
H##########H  $    $  H###
H          H ######## H   
H          H          H   
H      $   H    @ $   H   
##########################