          &          &    
VHVHVHVHVHVHVHVHVHVHVHVHV|
VHVHVHVHVHVHVHVHVHVHVHVHV|
#H H#H$H#H H#H$H#H H#H$H#|
#HVH#HVH#HVH#HVH#HVH#HVH#|
#HVH#HVH#HVH#HVH#HVH#HVH#|
#HVH#HVH#HVH#HVH#HVH#HVH#|
#H$H#H H#H$H#H H#H$H#H H#|
#HVH#HVH#HVH#HVH#HVH#HVH#|
#HVH#HVH#HVH#HVH#HVH#HVH#|
$H H H H H H H H H H H H#|
H########################|
H       $ & $   $ &      |
HXXXXXXXXXXXXXXXXXXXXXXXX|
H$     @                $|
##########################