            |             
----------- |             
  $    $ XH | $           
#########XXXXXXH  $HXH    
#X#X#X#XXXX   XXXXXXXH    
          X  $      XH &$ 
--------H X#####H   XX###H
        H X     H&    ###H
        H X ########H ###H
 $    $ H X #      #H ###H
###&  # H X #   $  #H #$#H
####### H X ########H # #H
        H   #  $   #H   #H
############# H##H ######H
          @   H $H       H
##########################