  & -- -             &    
####  H   -         ##H   
####  H ## -   &   -##H   
#$$#  H ##- #######  -H   
####  H     ####### H H###
      H---  ####### H  #$#
    -     H ####### H  ###
     #### H ##$$$## H     
   - #### H ####### H     
###- #$$# H-     - -H     
#$#  #### H -   - H  #### 
###       H   @   H  #### 
          H  ###  H  #$$# 
   ##     H  #$#  H  #### 
   ##     H  #V#  H       
          H       H       