                          
##|####         ----- &   
  | --  &           XXXXXH
  H#  #####H######--   # H
H###  #$---H-----#  ####H#
H     ####   ###H#  #$  H 
H     #----H----H#  #-  H 
H@#   #H$#$H$#H$H#  #   H$
H##   ############  ##H###
H    $#     $    #    H   
H    ##   ###H   #    H   
H  $# #      H   #  H#####
H  #  #   $  H   #$ H     
H$#   # H######H ##$H     
H#  $ # H#  $  H   #H     
##########################