    $    $     $      &$  
H######H### #####H## ####H
H      H         H       H
 H      H  -    H       H 
H      H  - -    H       H
 H      H-   -  H ------H 
H------H      -  H       H
    &   H-     -H       H 
###### H  -   -  H   &$ $H
## ###  H  - -  H   -###XX
 $   $ H    -    H  -###XX
##V###  H  - -  H   -###XX
##V# # H  -   -  H  -##$$X
  $ $   H-     -H   -XXXXX
###### H    $ @  H$  XXXXX
##########################