##XX#            |X#XX###X
#XX##            |#XX###XX
  X#X#  $      $ |#X     X
H   X##X###XH##X |#X #XH X
HX  X#XX###XH ##$|X  #XH X
H#     X##XXH  #### $#XH X
H##$    #XX#H       ##XH$ 
HX####   X##H  ------#XX#H
HXX#X##$  #XH $      #X  H
H    H##   XX#XX#    #X  H
X##XXHX##           $#X  H
##XXXH#X##$   &   $###X  H
  $  HXX###VXXXXXV###XXH##
HX###XX   &         @  HX#
H###X  H##XX#XX#X#XX##XXX#
H  $   H            &  X#X