X|                      |X
X| &$$$$$$$$ $$$$$$$$$& |X
XXXXXXXXXXXX|XXXXXXXXXXXXX
     $ $    |     $ $     
   XHXXXX   |   XHXXXX    
    H$ $    |    H$ $     
  XXXXXXHX  |  XXXXXXHX   
     $ $H   |     $ $H    
 XHXXXXXXXX | XHXXXXXXXX  
  H  $ $    |  H  $ $     
XXXXXXXXXXHX|XXXXXXXXXXXHX
     $  $ H |    $  $   H 
XHXXXXXXXXXX|XXXXXXXXXXXXX
 H                        
 H   $  $      @ $  $    &
##########################