                         |
                         |
                   &-$$$-|
  $-               H$###$H
$H# $-            $H#####H
#H  #           $ #H##$##H
 H    $-        #H-H#####H
 H    #       $ -H  $###$ 
 H            #H          
 H      $      H    $$$$  
 H      #   $ -H   $####$ 
 H          #H     ####HV 
 H       $-  H     ###HV# 
 H       # $-H     ##HV## 
 H        $# H     #HV### 
 H @      #  H &   HV#### 