                    |     
   &           X    |  & $
HXXXX XXXXXXXHXX   #|#H###
H      ---   HX$##H#|#H###
#H## ##  H#& H ###H#|#H#$#
 H  ##$# H # H##  H#|#H###
H   ####VH  #H  H###|#H   
H   @    H   #  H#  | ###H
H####### # $#  $H#H######H
H#######V# #  ####H##    H
H#######V#     $##H  #####
H#$   ##V#----H# #H-----  
H#   $##V#H   #  #$   # #H
H#######V#H  #######H##$#H
H   ##$   H ##      H ###H
H#########H##########    H