|                         
|                         
XXXXXH               HXXXX
#    H   &         & H    
#    H#######XXX#####H    
#    H               H    
#  --H               H    
# $ $H    $#$     $$$H    
# #$#H--  # # $$$ ###H--  
# #$#H$ $--$# ### #$#H$ $-
# ###H#$# $#$ $$$ ###H#$# 
#   #H$#$ ### ### #$#H$#$ 
#   #H#$#         ###H#$# 
#    H-H             H-H  
#    H    @          H    
##XX#########XXXX#########