XXXXXXXXXXX | XXXXXXXXXXXX
--------H#X-|-X#H---------
      $ H#--|--#H $       
   $  ##H--$|$--H##  $    
  $##V-HH#X#|#X#HH-#V# $  
 $##--H-#V-H|H-V#-H--###$ 
$##--H-----H|H-----H---##$
V---H------H|H------H----V
---H&------H|H------&H----
   H######VH@HV######H    
 $ H       ###       H  $ 
H  H    &  #$#  &    H   H
H--H#V#####H H#####V#H---H
H$  H      H H      H  $ H
H   H  $   H H  $   H    H
########X#######X######XXX