                  H   |   
        --        H   |   
$   $  -- H     --H  $|&  
####H--   H &  ---#V##H#H 
    H  X#V#H  ---$#$  |#H 
VV###H  $  H-HXX X######H 
V$   H  X    H   XXXX --H 
 V$  H      $H $     HX   
  #$ H#V##HXXXXXXH#VXHX   
  H#$H    H  $   H   HX   
  H VHX   H#V####H##XHX   
  H -H  $ H  $   H  XHX   
  HX $  X H####V#H X$H$X  
  H  X    H  $   H XXHXX  
  H       H##V###H  &H    
##########H  &  @H########