            ||            
 & HHHHH  $$||$$  HHHHH & 
   HHHHH H######H HHH H   
 H#H H H H  $   H H H H#H 
 H#H H H H######H H H H#H 
  #H H H-H  @ $ H-H H H#  
  $X H X-########-X H X$  
  VH H H-H######H-H H HV  
 HVH H H-H######H-H H HVH 
 HHH H H  H#VV#H  H H HHH 
 HHH H H  H#VV#H  H H HHH 
  HH H H   #$$#   H H HH  
   HHH H          H HHH   
    HHHH          HHHH    
     HHH          HHH     
      &H##########H&      