---------------           
     $         H&         
    $$$       HHH         
    $$$       HHH         
   $$        HH           
 $$ $$$    HH HHH  -------
$$ $$  $$ HH HH  HH  &    
   HH        HH     HHHHH 
 & HHH       HHH    $$$$$ 
HHHH HH   HHHH HH   HHHHH 
     HH        HH   $$$$$ 
     HH      @ HH   HHHHH 
###########H##############
           H              
           H              
##########################