                       |  
   $                   |  
HX##                   |XH
HX$## $               $|XH
H  #$###         & ######H
H  # #  ###$    ### $    H
H--  #$ #  # $ ##$ XXXX  H
H  ######   ##V#      ##XH
H$ @            #XXXH# $ H
HXXXX--------       H###$H
H   X    &$$$$      H  ###
H $ X$  XXXXXXXXX   H $X $
H#####              H##XX#
H----H------        H     
     H              H&    
   $ H   #################