                            
######H                     
#    #H    H#########H      
#  $ #H    H         H####  
######H    H         H      
#     H----H------   H   $  
#     H    H     H#########H
#     H    H     H         H
#     H    H#####H         H
###########H         H###H##
#####      H         H   H  
# $ #      H   ------H   H &
########H#######     H  ####
        H            H  #   
        H            H  #$ S
############################
