   @@@@@@@@@           S    
  @         @          S @@ 
 @   $$ 0    #H        S @@ 
@@##H########@@H    0  S$@@ 
@###H###########H##@@@#H@@@@
@##HHH#-------#HHH#----H---H
@##H H#  $    #H H# $    $ H
@##H H#  &    #H H#        H
@##H$H####H####H$H#@      @H
@#########H################H
@      ##HHH##  $    $   $ H
@------#HH HH--------------H
@ $    #H   H            0 H
@       H   H  ########### H
@@@@    H   H ### $##  $ ##H
@######@H$ $H  #############