S            ##            S
S            @@            S
S $       $  ##  $       $ S
@#@#@#@#@#@#H@@H#@#@#@#@#@#@
   $     $  H##H  $     $   
H@#@#@#@#@#@#@@#@#@#@#@#@#@H
H   $   $    ##    $   $   H
@#@#@#@#@#@#H@@H#@#@#@#@#@#@
    $0 0$   H##H   $0 0$    
H@#@#@#@#@#@#@@#@#@#@#@#@#@H
H  $     $   ##   $     $  H
@#@#@#@#@#@#H@@H#@#@#@#@#@#@
  $       $ H##H $       $  
H@#@#@#@#@#@#@@#@#@#@#@#@#@H
H            &             H
#@#@#@#@#@#@#@#@#@#@#@#@#@#@