                            
  S                       S 
  H#######################H 
  H H##   $   $ 0 $   ##H H 
  H###H###############H###H 
  H H H ### $   $0##H H H H 
  ##H###H H#######H H###H## 
  H H H H H H###H H H H H H 
  H###H###H H $ H H###H###H 
$ H H H H H0H@@@H0H H H H H$
####H###H$H@H@@@H@H$H###H###
##H H H H@H@H@@@H@H@H H H H#
##H## H@H@H@H@@@H@H@H@H ##H#
##H H@H@H@H@H@@@H@H@H@H@H H#
##H@H H H H H  &H H H H H@H#
############H#$#H###########