@@@@@@@@@@@@@@@@@@@@@@S    @
@         0           S    @
@    H#@##@@#H@       S    @
@    H      SH@#@##@@#S    @
@ ##@H     HSH# # 0#-------@
@$   H   $SHS## # @#      $@
@    H   HSHS#  #  #      0@
@H   H   HSHS# $#& #      #@
@H   H   HS@##  ## #     $#@
@H@@@@X#@@S@     # #     ##@
@H --------@-----# #  $   #@
@H     $  H     ## #    ###@
@H  H@X@@@H@@@#H#  #   $#  @
@H  H@   @H@  #H####X#@# $ @
@H  H@   @H@$ #H        ##@@
@H $H@ 0 @H@#####@@###@####@