 S                          
  S                         
 H$    $H      $H     $H    
 $H    H$      H$     H$    
 H$    $H      $H     $H    
 $H    H$      H$     H$    
 H$    $H      $H     $H    
 $H    H$      H$     H$    
 H$    $H      $H     $H    
 $H    H$      H$     H$    
 H$    $H      $H     $H    
 $H    H$      H$     H$    
 H$    $H      $H     $H    
 $H    H$      H$     H$    
&H$    $H     0$H   0 $H  0 
############################