 -  0   #### 0  $   ####    
H H####H####H###### #######H
H H####H  $ H###$## ####$##H
H H#$$#H###########    ####H
H #####H     --------------H
H     #H0        $  $       
H#X#H #H#####X#######H $ $  
H$ #H #H----- -----H@@@@@@@@
## #H #H    $ $    H  &$  $ 
   $H #H#####X#####H#######H
##H@@ #H-----------H       H
##H   $H    $     @######H H
##H##############S@    $ H H
$#H#             S@#####X# H
##H#     $    $  S@    0   H
############################