S               S  @####    
S###############S  @ $H# $  
S-----------H  #H--@##H# @@@
$H#@#     $ H--#H   $ H#   H
@H   ##     H  #H  @##H#  $H
@H##  $#   &H  #H $@0 H#H--H
HH $########H  #H  @#H##H  H
H  ###     @H  #H    H  H $ 
H   ##    $@H  ##H   H  H###
HH   ######@H0  ###H H  H   
@H###------@##H   ###HH H##H
#H    0       #@H   ##H#   H
#H#######H      #@H   H#   H
#H##$####H#####H###@@HH### H
#H#####$#H#####H$  $ HH#$  H
#H###################H#####H