                            
                            
@#####H                     
@    #H    H#########H   S  
@$$$$#H    H         H####  
@#####H    H         H      
@     H----H------   H   $  
@     H    H     H#########H
@     H    H     H         H
@     H    H#####H         H
@##########H         H###H##
@####      H         H   H  
@$$$#      H   ------H   H  
@#######H#######     H  @@@@
        H            H      
        H   &        H      
@@@@@@@@@@@@@@@@@@@@@@@@@@@@