          $              S  
        H#######  $      S  
    $   H      ######    S  
##########H         $    S  
          H######S#####H##  
0         H      S     H    
##########H      S 0   H   $
##########H#######@@   H####
##########H            H    
##########H       $ ---H    
##      ##H       ##   H    
##  $$  ##H     $      H    
###########H#######H   H    
           H       ########H
    $    & H               H
############################