            0          0    
XHXHXHXHXHXHXHXHXHXHXHXHXHXS
XHXHXHXHXHXHXHXHXHXHXHXHXHXS
$H#H H#H$H#H H#H$H#H H#H$H#S
XH#HXH#HXH#HXH#HXH#HXH#HXH#S
XH#HXH#HXH#HXH#HXH#HXH#HXH#S
XH#HXH#HXH#HXH#HXH#HXH#HXH#S
 H#H$H#H H#H$H#H H#H$H#H H#S
XH#HXH#HXH#HXH#HXH#HXH#HXH#S
XH#HXH#HXH#HXH#HXH#HXH#HXH#S
$H H H H H H H H H H H H H#S
H##########################S
H         $ 0 $   $ 0      S
H@@@@@@@@@@@@@@@@@@@@@@@@@@S
H$       &                $S
############################