H######################
H######################
H######################
H######################
H#                     
H##X#########          
H#          #          
H#X##########          
H                      
H     H#X##            
H    &H X##  $$$$$$$ S 
#######################