                                                                                                              
                                                                                                              
      #        #                                                                  #####                       
       #     ##       ###     #             #              #     ####        #####                            
        #   #       ##   ##   #             #              #     #   ###     #                                
         #$#        #     #   #             #             # #    #      #    #       ###                      
         ##        #       #   #            #             # #    #     ##    #$  ####                         
        #          #       #   #           #             #  #    ######       ###                             
      ##           #       #   #           #             #   #  #    #        #                               
     #              #     #    #          #             ######  #     ##      #      ###                      
                    ## S ##     ##      ###             #    #  #       #     #  ####                         
                      ###         ######               #      # #        #    ###                             
                                                       #      # #                         $                   
                                                                                       ######                 
      #                 #                                                          ####      ###              
       #                #  ####               #                           #####    #            #             
       #               #       ########       #       #  #      #    #####          #           #             
        #              #         ##    ####   ##      #  ##     #    #              #            #            
        #             #         ###           ##     #   ##     #    #              #          ##             
         #            #         ##           #  #    #   # #    #    #              #     #####               
         #     #     #          ##           #  #    #   #  #   #    #      ###      #####     #              
          #   # #    #         ###           #   #   #   #   #  #    # $####         #          #             
          #$$#   #  #          ###           #   #  #   #    #   #    ##             #           ##           
           ##    #$$#          ##            #   #  #   #     #  #    #              #             #          
           #      ##     #### ###           #     # #   #      # #    #               #             #         
                   #         ######$        #     # #   #       ##    #        ###    #              #        
                                   ####     #      #    #       ##    #  ######       #                       
                                                                      ###                                     
                                                                                                              
                                                                                                              
                                                                                                              
                                                                                                              
                                                   &                                                          
##############################################################################################################