             S              
-----------  S              
  $    $ @H  S $            
#########@@@@@@@H  $H@H     
#@#@#@#@@@@@   @@@@@@@H     
          @@  $      @H 0$  
--------H @@#####H   @@####H
        H @@     H0    ####H
        H @@ ########H ####H
 $    $ H @@ #      #H ####H
###0  # H @@ #   $  #H ##$#H
####### H @@ ########H ## #H
        H    #  $   #H    #H
############## H##H #######H
          &    H $H        H
############################