S          #################
S          ########@ ------#
S    $   H#    $   @H # $  #
#########H@####### @H ######
    $    H@    $   @H ######
H#########@ ##X### @H ######
H    0$   @      $ @H   0   
#########H@ ##XXX# ########H
 $       H@    $           H
H#########@ ##X###         H
H  $      @      $         H
#########H@ ##XXX#  #####  H
        $H@      $  #  $#  H
H#########@ ##X###    H##  H
H   0       &         H# $ H
############################