S                           
S      ------------------###
H    $0         H          #
H##X####        H          #
H      #        H $0H ## $ #
H $ H  # $   ---H###H#######
H###H$ ##### $  H   H       
    H##########XH   H      $
H   H##  $ ####XH $#H-----##
H###H##########XH###H $ H ##
H     #---------H#$#HX##H ##
H$0H  #     $   H###H   H ##
###H  #   $ ##  H###H   H ##
   H  # $ ##    H###H   H ##
   H &####    $ H###H  0H ##
############################