##S#@#@#@#@#@@# #S#@ ##S####
##S######@#@@H@ @S@# # S  H#
#@S      #@  H   S $  0S  H#
###X##H------H##X#########H#
 & $  H$H#@$ H @  @#@  #  H#
#####H##H@#@  $ @    @ ---H#
  @# H@ H@@@#@@# @  -----#H#
$ 0  H  H  #---------@ $##H#
#X@##H  H$@@#$ #@$  @  ## H#
@X @ H  $@#@@#$ @#---H#   H#
  #  H $@ $$$ @$  @  H    H 
H----H$@ H#@#  @$   #H######
H H  @@--H      @  $ H @@@@@
H H#@#$$ H--H  H ####H  @  #
H H$ $##$0$$H--H  ##@H   0$#
############H $H$###########