             HH             
  0H         HH         H 0 
 ##H##     ##HH##     ##H## 
##$H$##   ###HH###   ##$H$##
#  H     ##$ HH $##  #  H   
##$H$ ---##  HH      ##$H$  
 ##H##   ##$ HH0$     ##H## 
  $H$##   ###HH##      $H$##
   H  #    ##HH### --   H  #
##$H$##    $ HH $##  ##$H$##
 #XHX#       HH  ##   ##HX# 
   H     ##$ HH0$##     H   
          ###HH###          
           ##HH##           
        &    HH             
#############HH#############