|                         
|-------------------------
H# &   #           #     #
H #####             ##### 
H # ###             #$### 
H ##### &    &    & ##### 
H ### #V############### # 
H #####V### $## $######H# 
H #####V###############H# 
H #####V###############H# 
H #####V####    #######H# 
H #####V####    #######H# 
H #####V####   $H######H# 
H           ####H------H  
H          XXXX           
H      @  XXXX    &       