          $             | 
        H######   $     | 
    $   H     ######    | 
##########H        $    | 
          H######|####H## 
&         H      |    H   
##########H      | &  H  $
##########H#######XX  H###
##########H           H   
##########H      $ ---H   
##      ##H      ##   H   
##  $$  ##H    $      H   
###########H######H   H   
           H      #######H
    $    @ H             H
##########################