                         S  
                    &     S 
   X####HH######HHHHH      S
         H   #  H         S 
    $     H H#  H        S  
    #$     HH#  H       S   
   ###$     H#  H      S    
  #####$    H#  H     S     
########    H#  H      S    
 $#####     H#  H       S   
   ###      H#  H        S  
    #       H#  H         S 
       0    H#  H   0      S
 H##############X######### S
 ###############         H#S
################   $$$$$$H##