S                          S
S                          S
S         0                S
H###X######################H
H###X######################H
H   $   ##--------##       H
H       $#H    0 $##    0  H
H  ###  ##H ########  #####H
H  #$#  ##H       ##  ##$##H
H   &   ##H       ##  #####H
H  ###  ########HH##  ##$##H
H  ###  ########HH##  #####H
H  ###  ##      H ##       H
H  ###  ##     $H ##    $  H
##########H#########H#######
#######  $H###### $ H#######