                        | 
     &                  | 
H##########H  &  $   $  | 
H          H#####H  ##H###
H $      $ H    XH    H   
H #  ### # H $$ XH  & H   
H # ###  # H XX X########X
H #  ### # H XX         X$
H # ###  # H X------ $  XH
H #$ ### # H X$     ###HXH
H #####  # H XX        H H
H ######## H XX   $    H##
H          H XX ####   H  
HXXXXXXXX#XXXXX        H  
H             @        H  
##########################