#####|################ ###
     |# ------            
|##| |# #$  #H#         & 
| ##### #####H#####$ #H###
#|    $---###H########H# #
#######   # #H### ####H# #
       &    #H### ## #H#$ 
H#######H#H$#H### ## #H###
H       H####H###$ # #H## 
H            H###### #H##$
H       #    H        H   
H###H####HX#X#X#X#X#X#H#X#
H###H####H#####  #####H#X#
H   H    H######  ####H   
H########H#######$ ######H
H@       H $######  &    H