 --------$$######$$-------- 
H       $###HHHH###$       H
H      $##HHH00HHH##$      H
H      ##HH      HH##      H
H     $#HH        HH#$     H
H     ##H$        $H##     H
H     #HH$        $HH#     H
H     #H$$        $$H#     H
H     #HH$        $HH#     H
H     ##H$        $H##     H
H      #HH$      $HH#      H
H      #XHH$$  $$HHX#      H
H       X#HHH$$HHH#X       H
H        ###HHHH###        H
H&      0  ######  0       H
#########H        H#########