|                         
|     &                   
|#########XXXXXX#XXXX#XXXH
$                    H   H
##        X   $    $---$ H
####HH#HH########  #   # H
   #HH HH# XX####     &  H
   #HH$HH# X #### ###H###H
   ####### X$###     H   H
                     H   H
       @      #H#####HXXXH
##H#######H### H $$  H   H
  H       H    H XX    ##H
  H##$#   H  ### XX####  H
  H####  &H   $  XX      H
#################XX####XXX