S                           
S      0                    
S##########@@@@@@#@@@@#@@@@H
$                     H    H
##         @   $    $---$  H
#####HH#HH########  #   #  H
    #HH HH# @@####     0   H
    #HH$HH# @ #### ###H####H
    ####### @$###     H    H
                      H    H
       &       #H#####H@@@@H
##H########H### H $$  H    H
  H        H    H @@     ##H
  H##$#    H  ### @@###### H
  H####   0H   $  @@       H
##################@@####@@@@