|                        |
|                        |
#####H####H& &H####H######
 -   H    HXHXH    H    - 
H ####      H   $  ##### H
H ####  #HHHHHHH#  ##### H
H ##$#  #HXXXXXH#  #$### H
H ####  #HHHHHHH#  ##### H
H        -------         H
H &  H      X      H   & H
HXXXXH    $XXX$    HXXXXXH
H    H    XXXXX    H     H
H####H   XXXXXXX   H#####H
H    H $XXXXXXXXX$ H     H
HXXXXH XXXXXXXXXXX HXXXXXH
$    HXXXXXXXXXXXXXH @   $