#########################|
   HHHHHHHHHHHHHHHHHHH   |
 @ H HHH    H   HH   H & |
###H HHH HH H HH H HHH###|
   H HHH HH H HH H   H   |
 & H HHH HH H HH H HHH & |
###H   H    H   HH   H###|
HHHHHHHHHHHHHHHHHHHHHHHHHH
 $ H $ H $  H  $ H $ H $ H
HHHHHHHHHHHHHHHHHHHHHHHHHH
   H H H HH H HH H   H   H
 H H H H  H H  H H HHH H H
  HH H H H  H H  H   H  HH
 H H H H HH H HH H HHH H H
 H H   H HH H HH H   H H H
HHHHHHHHHHHHHHHHHHHHHHHHHH