 $                  |     
####H           &   |     
  $ H         H######H  $ 
#######H######H     ######
       H      H $       $ 
     $ H      H###########
#H#####H   $  H           
 H   $ HXXXXXXH      $    
#H#####H      #####H#####H
       H &    $    H     H
 $     H###H#######XXXXXXX
###H####   H  $      $ &  
   H      H########H######
   H------H        H      
   H        @      H    $ 
######################|###