           $              
 ------- ####H@           
H          $ H    $    $  
H        HXXXX #####H#####
H        H $        H     
H######H ####H      H     
H      H   $ H&H#########H
H      H HXXXX HXXXXXXXXXH
H    $H# H $   HX    $  XH
H    H#  ####H HXHXXXXXHXH
H  $H#     $ H HXHX  $ HXH
H  H#    HXXXX HXHXXXXXXXH
H H#     H $   HXH   $   H
HH#      ####H HXXXXXXXXXX
HH  &        | H   &      
##########################