    -    - -      -  $  $ 
-  - -  - H -    - H######
 --   --  H  -  -  H      
          H   --   H  &   
 $  $  $  H   -    HXXXXXH
XXXXXXVXXXXXH-     HX $ XH
            X      HXHX$XH
           $X  @ $ HXHX$XH
H########H#XXH####-HXHX$XH
H    &   H##HH     HXHX$XH
H   ##   H##H   $&  XHX$XH
H ##  ## H##XX#####HXH----
H ##  ## H##       H      
H ##$$## H#     --$H #### 
H $$##$$ H##  H#  #H##$$##
##########################