H   -                  H----
H    H                 H @  
H    H             0   H @$$
H $  H####  $  $H#####X#H###
H##  H   #########      HH#X
H    H                   HHX
H     H-------------------HH
H     H                    H
H     H $       0   $     $H
H     #####H@@@@@@@@@@##X###
H---       H          ---   
   0$      H         H      
#########H H   $     H-   $ 
        #####H@@@H#### #$###
$       &    H   H   0 #####
#############H   H##########