        H                 
        H     $    &      
----  $ |    XXXXXXXXXXXXH
H  XXXXXX                H
H        ----  ----- HXXXX
H--------       H    H    
    &        $  H#   H    
HXXXXXXXXXXXXXXXX#   XXXXH
H                       HH
H      $    $     &  X  H 
XXXX##XXXH #X#XXXXXXXX  H 
         H              H 
       $ H     $        H 
HXXXXXXXXX XXXXXXX      H 
H                 ------H 
H         @       &       