                          
         &     &      $ $|
     H#############  H####
     H ###########  H#####
H#####  #$##$##$#  H######
H######          &H#######
H############V########    
H####### $ $  $ $##### $$ 
H#########V##V############
H        &       $######  
H H#####H#####H -H####  $H
H H  H  H  H  H  ###  $H##
H H$$H$$H$$H$$H  #  $H####
H H#####H#####H   $H######
H             @  H########
H#########################