###########| #############
#---------#|  #---------# 
 #$  H  $# |   #$  H  $#  
  #$ H $#  |    #$ H $#   
   #$H$#   |     #$H$#    
    #H#    |XXXXX##H#     
 @  #H#    |X   $ #H#  &  
###H#H#####V#######H#####H
   H H &           H     H
H##X#H#############H#X####
H---#H#-----------#H#     
H $# H #$       $# H #    
H$# $H$ #$     $#  H  #   
H# $#H#$ #$ H###   H   #$ 
H $##H$#HH#H#X#  & H  $ ##
#########H H $############