         |                
         |                
 $ & $  XHX   --------@   
HX###X# XH$          ###  
HX      XHX    $         $
HX---   XHX  ####---     H
HX     $XHX  $        $  H
H  $X##XXHX###      H### H
HX#XX   XHX      &$ H#   H
HX------$HX   ########   H
HX    $ XHX   $       $  H
HX   X##XHX--####--  H#  H
HX$     XHX        $ H   H
HX##    XHX      #####   H
H    &   H               H
X###X###XXXX###X####XX#XXX