                 #######  
--------$      &| ######  
H      H#H----   | ######H
H     HV#VH $H$   | ##  #H
H-----HV#VH ###H   | #$ #H
H     HV#VH&###H    | ###H
H&    HHHHH ###H     | ##H
H---- XVHVX ###H      | #H
#$  H XVHVX    H       ||H
##$ H XVHVX H--H---------H
###$H XVHVX H             
####H&XVHVX H------H##$###
    H XVHVX H     HX######
    H XVHVX H    HX#######
    H  @H   H    HX#######
##########################