   |                      
   |              &       
   |            H#####H   
$H####H#H&    $ H#   #H   
H#####H#####H##H######H##H
H    XH $  XH XH  X# #H $H
H ###XH X# XH XH $X# #H #H
H $##XH   $XH XH # # #H #H
H ###XH # #XH XH XX  #H #H
H   $XH X   H$#H ##$ #H&$H
H#####H#####HV#H######H##H
H$------ $$ H  & ##    X$H
XXH    ##XXX##HXX#$    $XH
  H###$#XXXXX#HXXXXXXHXXXH
@ H#$##$$$$$$ H$     H   H
XXXXX####XXXXXXX##########