|                         
|      -----------------##
H    $&        H         #
H##V####       H         #
H      #       H $&H ## $#
H $ H  # $   --H###H######
H###H$ ##### $ H   H      
    H#########VH   H    $ 
H   H##  $ ###VH $#H-----#
H###H#########VH###H $ H #
H     #--------H#$#HV##H #
H$&H  #     $  H###H   H #
###H  #   $ ## H###H   H #
   H  # $ ##   H###H   H #
   H @####   $ H###H  &H #
##########################