         $   $            
 $   $   ##H##  $   $   $ 
 ##H##     H    ##H##  #H#
   H      H       H     H 
    H      H       H   H  
   H       &H  $$   H   H 
  H        H   ##  H --- H
   H      H       H     H 
    H      H ----- H   H@ 
   H ----- &H       H   ##
  H   $$   H       H      
   H  ##  H       H       
  & H      H       H &    
#####VVVVVVVVVVVVVV######H
                         H
##########################