##############           |
             #           |
 ------------HH#######$  |
             H#  $  # #--H
$ $&      @  H#     # #& H
H######HXXXXXX#XX   H  # H
H     #H      ###   H    H
H$    #H-------   & #H   H
H   ##XH      #######H   H
H  ##$XH    ###     #H####
H #   XH  $##$# $$  #H## #
H#    XH  ##  #######H# # 
H#$   XH ##   #-----#H## #
H     HHH#    #  $  #H#$# 
H     H#H           #H## #
##########################