 ---      $$$$$$$     --- 
H   ##################   H
H XX##################XX H
H   ##################   H
H&XH##################HX&H
XXXH#    #    #    ###HXXX
   H#$$$$#$$$$#$$$$###H   
   H##################H   
   H##################H   
   H##################H   
   H###    #    #    #H   
   H###$$$$#$$$$#$$$$#H   
   H##################H   
   H##################H   
   H##################H   
   H                 @H   