#                       #|
#     $  &   ----------$#|
############HH   & $  H##|
###         HH########## |
####  $  &  HH       ##  |
############HH $    ###H |
######      HH#######  H |
  $  ##  $  HH    ###V#H |
H###########HH$  ##    H |
H# # ####   HH#### $   H |
H H#H# $##  HH #####V##H |
XXH H#H####@HH # $     H |
XXXXH H# ###HH####V####H |
XXXXXXHHH# #HH#        H |
        H H HH         H |
##########################