     -----------$         
XXXXX   ##     #XXXXXX#H  
X-----  $$     #      #H  
XH     ###V    #     $#H  
XH$$   $  $    ######V#H  
XXXH $ #V##          &HH  
   H       $   $   &-- H  
   H     #XXXXXXXXX#-- H  
   H$& $ #&     $  #   H  
   H####H######V####   H  
    #  #H              H  
    #  #H              H  
    #$$#H              H  
    ##V#H              H  
        H    &  @      H  
###XXXX###XXXX###XXXX###XX