@S#@@@#@@##@##@@#@ @@#@@##@#
@HSSSSS@S@#@@#S@SSSSSS@@####
@H & $S@S $$$ S S  0 S $  S#
@H@#@#S@S#@##@H#H@###H####S#
@H $  S@S $$$ H H $##H###@S#
@H@#@SS@S ### H H @@$H$##$S#
@HSSS $@S     H$H  #@H@#@@S#
@H  S##@S  $  H@H  $ H----S#
@H$ 0S @S ### H@H  #@H  $@##
@H####H@S  #  H$H  # H ##$S#
@H  @ H@SSSSSSH@H  # H   @H@
@H  @ H---------H$0# H@$$$H#
@H  @$H@####H $@H###########
@H  @#H@   #####@#@-------H#
@H $  H  $   $       0 $$$H#
@######@#@@@@@@@@@@@@#@@@@H#