            HH---HHHHH####
           H##H--H$$ H####
          H####H  HH$H H H
         H######H   HH$H$H
         H######H    HHHHH
         H#X#XVXH    H H H
         H$X#XV$H    H H H
         H#X#XVXH    H$H$H
$--------H#X#XVXH    HHHHH
H$       H$X#XV$H    H H H
#H$      H#X#XVXH    H H H
##H$     H#X#XVXH    H$H$H
###H$    H$###V$H    HHHHH
####H$   H######H    H H H
#####H$ HX# #X #XH  @H$H$H
######H&HX# #X #XH&H######