|                         
|XXXX XXXXXXXXX#XXXXXXXXX$
|    $   $----   --------H
|       H##  #####     ##H
|     $ H       $#  # $#$H
|    ###H  $ @  ##  #V##XH
| $     H#####H  # &     H
| ###   H#   #H  #---H####
|     & H#$  #H  #   H--- 
|   H#########H###   H  $ 
### H#$ # $  #   #   H ###
$ ##H#########   #   H #  
####H---$$X$$#$  ##XXXHX##
   #H  ###X#####H#    H  $
 $ #H    $      HH  & H#H 
####H############H########