                & & &-    
              H###### H##H
              H#    # H##H
          H######   # H##H
          H     #   # H##H
      H######   #$$$# H##H
      H#    #   ##### H##H
   H#####   #$$$#     H##H
  &H#   #   ##### H######H
#####   #$$$#    &H#    #H
#   #   ##### H######   #H
#   #$$$#     H#    #   #H
#   ##### H##### $$$#$$$#H
#$$$#     H#XXXXXX#XXX#XXH
##### H#####        @    H
      H###################