-----------------------H  
  $    $    $      $   H  
####  #### ###V   ##V# H  
     $    $      $     H  
#  #V##  ##V#  V###  # H  
 $      $   $      $   H  
####  ####  ###V  ##V# H  
    $     $     $      H  
#  ##V#  #V##  V###  # H  
  $     $     $    $   H  
####  ####  ###V  ##V# H  
&    @           &     H &
########################|#
########################|#
######################  | 
###################### &|&