           &             |
   $                 $   |
 H###H    ##H##    H###H |
H# $ #HH#HHHHHH##HH# $ #H|
H#####H##HHHHHHH#H######H|
    &   HHHH$HHHH        |
########HHHHHHHHH########|
##$##   #HHHHHHH#  ##$## |
 ###     #HHHHH#    ###  |
  #       #HH##      #   |
           #H#           |
           #H#           |
           #H#           |
           #H#           |
   &        H     @      |
#########################|