XXXXXXXXXXX|  XX       X#X
#######X##X|  #X       #X#
   $  #X#XX|  XX       #  
HX###V#   X| & X      $# $
H####   ---H##XXV#####HX H
H# $# ---XXH#   VX####H# H
H###---  XXH#---VX####HX#H
H##---     HX    $ ##XH##H
H#--$   #X#H#   V##XX#H##H
H-- X------H   ---- ##H #H
   X#&  $ XHV##X@ $   H##H
##V#X## X#XHV##X#XX#X    H
##V#X     XHV   & $ XX####
##V#X------HV## ####X  $ #
##     $  XH         #####
#X####X#H  H  H###X#######