##########    ######XX###|
-------------------- ## #|
 H#########H |#-----H----|
@H$X$$$$   H |#$  $$H   $|
#H#####X###H |###H###V#H#|
 HHHHH X  $H |#$ H-----H |
$  X$H  $$#H |#X H XXX H$|
######V####H |#$ H&  $$HXH
  $X$$ X  #H |######H####H
  XXXX X  #H-H#$    H  $$|
 $$$ $$X$ #H&H#X$   H ###H
H###V####H########H######H
H--------H##$-----H-X ---H
H $  $$$ H  H $ $ H XH$ $#
#H##HX#H###VH##X#V#####H##
$H$$H& H    H        $$H$$