     X------  --- HH##H  |
$ & $X-----$##   HH##HH  |
###H#X    $##   HH##HH$  |
   H X   $##   HH##HH$ XX|
$  H$X  $##   HH##HH$ XX |
###H#X $##   HH##HH$ XX  |
  @H X$##   HH##HH$ XX $$|
###H$X##   HH##HH$ XX H## 
###H#X#   HH##HH$ XX  H$$ 
#$#H X $$HH& HH$ XX H#### 
###H$X##########HX  H$ &$ 
$##H#X----------HX H##### 
###H$X $  H      X H$   $ 
#XXXXX##  H #### X H##### 
         &H##$$##X H$   $ 
##########X######X #######