           HHH            
          HHHH            
            HH            
  &        HHHH        &  
----------HHHHHH----------
----------HHHHHH----------
 ---------HHHHHH--------- 
   -------HHHHHH-------   
     -----HHHHHH-----     
        --HHHHHH--        
$ $ $ $ $ HHHHHH $ $ $ $ $
          HH&@HH          
##########HH##HH##########
##########HH##HH##########
 $ $ $ $   H  H   $ $ $ $ 
##########################