            HHH             
           HHHH             
             HH             
  0         HHHH         0  
-----------HHHHHH-----------
-----------HHHHHH-----------
 ----------HHHHHH---------- 
   --------HHHHHH--------   
     ------HHHHHH------     
        ---HHHHHH---        
$ $ $ $ $  HHHHHH  $ $ $ $ $
           HH0&HH           
###########HH##HH###########
###########HH##HH###########
 $ $ $ $    H  H    $ $ $ $ 
############################