                   XXXXXXH
------------  &          H
 H         HXXXXXXX H# H|#
&HXH       H-----H #H #H  
XXXHXHX @        H  ## |#V
H--H H#V###XXX ##H ##H||#V
H  H H# $#   $   H # H#--V
H    H#  $#### XXH $H#$ $$
H    H# &#####   H #H#   #
H     # #####$ XXH||H#H###
H     # $##### $ H  # H## 
HV$   # ###### HXH ###H ##
H #   #H $#$ # H H  # H# $
H  #   H###### HXH # ## ##
H     #          H        
X#X#########XXXX#X#XXX#XXX