|                         
|                         
###############H## $    @ 
          &    H##V#XXXXXH
$  HHHHHHHHHHH H         H
#$ H  HHHHHHHH H $ $ H###H
 #$H  H        H #|# ####H
  #H  H$ $ $ $  H #      H
   #$ H#V#V#V# H     &$$$H
    # H         H    #H##H
      H H H H  H      H   
      H         H     H&  
       H H H   H      ###H
        H H H   H        H
    &    $|#   H   &     H
##########################