                         |
-------- #H         $$   |
   $#$  H#H#X#X#X#XVX#X#X#
  $# #$ H#H  $   $  ------
 $#   #$H##X#X#X#X#H     H
 #     VH#XXXXXXXXXH  $  H
        H--------H###V###H
                 H#      H
  $ @$           H#      H
H#######H &$ $   H# $  $&H
H &$  $ H#XXX#X#X#XX#XVX#H
H#######H####$ ###       H
H  $ $  H###### ##       H
H#######H####### #       H
H   $ $ H########  $  $  H
##########################