                           S
-------- #H            $  $S
   $#$  H#H#@#@#@#@#@X@#@#@#
  $# #$ H#H    $   $  ------
 $#   #$H##@#@#@#@#@#H     H
 #     XH#@@@@@@@@@@@H  $  H
        H----------H###X###H
                   H#      H
  $ &$             H#      H
H#######H 0 $  $   H# $  $0H
H 0$  $ H#@#@#@#@#@#@@#@X@#H
H#######H######$ ###       H
H  $ $  H######## ##       H
H#######H######### #       H
H   $ $ H##########  $  $  H
############################