                          
#####H|            |H#####
##HHH$|            |$HHH##
H###HHH$          $HHH#V#H
HHH#V#HHH$&    &$HHH###HHH
 $HHH###HHH$  $HHH#V#HHH$ 
   $HHH#V#HHHHHH###HHH$   
     $HHH###HH###HHH$     
       $HHH#HH#HHH$       
     $HHH###HH###HHH$     
   $HHH###HHHHHH#V#HHH$   
 $HHH#V#HHH$  $HHH###HHH$ 
HHH###HHH$      $HHH#V#HHH
H#V#HHH$          $HHH###H
##HHH$|            |$HHH##
#####H|       @    |H#####