   ------             -   
###      H--   & H####    
#$      H-- #####H####    
###     --  V###VH#$$#    
    ###V    V###VH####    
    ###V ##-V#$$VH    V###
    #$$V ## V###VH    V###
    ###V         H    V$$#
                 H    V###
        V##V     H        
V##V    V$$V     HV###    
V  V    V##V     HV### ## 
V $V             HV$$# ## 
V##V             HV###    
             &   H  @     
##########################