    ------              -   
 ###      H--   0  H####    
 #$      H-- ######H####    
 ###     --  X####XH#$$#    
     ###X    X####XH####    
     ###X ##-X#$$#XH    X###
     #$$X ## X####XH    X###
     ###X          H    X$$#
                   H    X###
         X##X      H        
X###X    X$$X      HX###    
X###X    X##X      HX### ## 
X $ X              HX$$# ## 
X###X              HX###    
              0    H &      
############################