 -                        - 
H ######################## H
H #    #  $  $#       #  # H
H # $  ####X###       #  # H
H #X####     # $0 $   # $# H
H #   #      ############# H
H # $ #      #      #    # H
H #####  $ 0 #      #    # H
H #   #########     #  $ # H
H #      #    #$  0 ##X### H
H # $  $ #    #######    # H
H ###X####    #   #      # H
H # $ #$   0$ #$  # $    # H
H ###X##########X######X## H
H           &      0       H
############################