            HH            
  &H        HH        H & 
 ##H##    ##HH##    ##H## 
##$H$##  ###HH###  ##$H$##
#  H    ##$ HH $## #  H   
##$H$ --##  HH     ##$H$  
 ##H##  ##$ HH&$    ##H## 
  $H$##  ###HH##     $H$##
   H  #   ##HH### -   H  #
##$H$##   $ HH $## ##$H$##
 #VHV#      HH  ##  ##HV# 
   H    ##$ HH&$##    H   
         ###HH###         
          ##HH##          
       @    HH            
############HH############