           |              
         #$|$#         #  
#---H-----#H#-----H---#   
 #$ H &   $H$   & H $#    
  #-H-H---#H#---H-H-#     
   #  H  V H V  H  #      
H---# H #--H--# H #------H
H-H  #H#       #H#     H-H
  H  #H#       #H#     H  
H-H  #H# @ $   #H####  H-H
H    #H#########H####    H
H-H  #H# ##### #H##$#  H-H
 $H  #H# ##$## #H####  H$ 
H-H& #H# ##### #H#    &H-H
H---- H -     - H ------ H
H    #H# ##### #H#       H