|              |  X####   
|##############|  X $H# $ 
|-----------H #H--X##H# XX
$H#X#     $ H-#H   $ H#  H
XH   ##     H #H  X##H# $H
XH##  $#   @H #H $X& H#H-H
HH $########H #H  X#H##H H
H  ###     XH #H    H  H$ 
H   ##    $XH ##H   H  H##
HH   ######XH& ###H H  H  
XH###------X#H   ###HH H#H
#H    &      #XH   ##H#  H
#H#######H     #XH   H#  H
#H##$####H####H###XXHH## H
#H#####$#H####H$  $ HH#$ H
#H##################H####H