      &  |       |  &     
          |     |         
           |   |          
         $###H###$        
         #$#$H$#$#        
  $     #$H H#H H$#   $ $ 
  ##H#H#####H H#####H#H## 
 $# H#H     HHH     H#H$# 
 # HH#HHHHHHHHHHHHHHH#HH #
 #H&$ #HHHHHH#HHHHHH# $&H#
  ###H #H$  H H  $H# H### 
   $##H######H######H##$  
   ## H    $ H $    H ##  
   # H##HHHHH#HHHHH##H #  
 $  H###HH#HHHHH#HH###H@$ 
##########################