                S           
 0-         -&  S     -     
 H H       H H  S    H H   H
H  HH     H   H S   H   H  H
 #$H H   H #$# HS  H #$# H-H
 ##H  ---H0### H---H0#H#   H
@##H##X##@##@##@##X##@H#X##H
#  H  X  #  $###  $# #H X  H
#--H--X--# H#----H----H-#--H
#  H  X  # H#  # HXH #0 $  H
#X@H#@#X@##H##@##@XH@##@#X#H
 X####   ##H##   #XH##   X#H
   H--- --#H#-- --XH#-- --#H
  #H#  $  #H#  $  #H   $  #H
 $#H#  @  #H#  @  #H#  @  #H
#X H X#@## H ##@## H ##@#X H