|                        |
|    $ &  $     $  & $   |
|||########H   H#######|||
           H   H          
      H#############H     
$  & $H     $ $     H$ & $
######H $ $#####$ $ H#####
      H ####   #### H     
    $ H      $      H $   
  H####################H  
  H          @         H  
  H $   $H#######H$   $H  
#########H       H########
         H       H        
  $      H       H     $  
#X#X#X#X#X#X#X#X#X#X#X#X#X