                       |  
                   @    | 
   V####HH#####HHHHH     |
         H   # H        | 
    $     H H# H       |  
    #$     HH# H      |   
   ###$     H# H     |    
  #####$    H# H    |     
########    H# H     |    
 $#####     H# H      |   
   ###      H# H       |  
    #       H# H        | 
       &    H# H   &     |
 H#############V######## |
 ##############        H#|
###############  $$$$$$H##