|                        |
|                        |
|         &              |
H###V####################H
H###V####################H
H   $   ##-------##      H
H       $#H   & $##   &  H
H  ###  ##H #######  ####H
H  #$#  ##H      ##  #$##H
H   @   ##H      ##  ####H
H  ###  #######HH##  #$##H
H  ###  #######HH##  ####H
H  ###  ##     H ##      H
H  ###  ##    $H ##   $  H
##########H########H######
#######  $H##### $ H######