   |                      
   |      $        $     $
HV#H    H###H    H##H#  #H
H  ######   H####H  H  $ H
H$ &        H    H  #### H
HV####         ##H#      H
H X####       ##      H# H
H X#####     ##     H#H  H
H X###########   $  H   ##
H X###########   ## H     
H X    ### ###      H   &$
H X  $ ## $ ##    & H   ##
H XH###########H####H   ##
H  H           H    H   ##
H  H       @        H   ##
##########################