XXXXXXXXXXXXXXXXXXXXXXXXX|
H---------------------H|||
H  H     ##  &   $    H|$ 
H  H ####################H
H  H ###                 H
H  H   # #################
H  H  H#   $  # $ # $ # $ 
H  H  H##H################
H  H--H  H##### ####      
H  H  H  H    # $#    &   
H  H  H  H--H ####H-######
H  H  H  H  H     H ######
H  H  H  H  H--H  H ######
H  H  H  H  H  H  H## $$$ 
H  H@ H  H &H  H  H##H####
##################H$$H####