   XXXXXXXX          |    
  X        X         | XX 
 X  $$ &    #H       | XX 
X##H########XXH    & |$XX 
###H###########H##XX#HXXXX
##HHH#-------#HHH#---H---H
##H H#  $    #H H# $   $ H
##H H#  @    #H H#       H
##H$H####H####H$H#X     XH
#########H###############H
      ##HHH##  $    $  $ H
------#HH HH-------------H
 $    #H   H           & H
       H   H  ########## H
XXX    H   H ### $## $ ##H
X#####XH$ $H  ############