   X     X     X         |
   X     X     X   $     |
   XV####X     X####  ###|
##         ###H&  $     $|
##########H   H######## #H
      @   H ##H    $    #H
H#########H $#H  #####H #H
--------##H ##H  #    H #H
  #  # $##H   HH # ###H #H
  #  #  #HH####H##$###H #H
  # $#  #H#      # ###H  H
  ####  #H# #### #    H#HH
H##  ##HHH# #$## #######H 
H   XX#HH##   #  ##$    H#
H   X   H##V####V#######H#
H###    H     &         H 