|                        |
|     @            &     |
|  X#H#X----------X#H#X  |
|  X$H X $      $ X H X  |
|X## H ##X      X## H$##X|
|X$  H  $X $   $X $ H #$X|
X####H   ##X  X#####H # #|
H    H     X $X$    H #  $
H    H#####XH#X##  $H ## #
H$ & H   &  H     ##H     
H####H   X##H###X   H   #H
HX $ H   #  H $ #   H  &XH
HX## H ###  H   ### H ##XH
H $# H X    H    $X H X$ H
H   ###     H      ###   H
##########################