X                        |
X    $$$$& & &     @     |
X#########V##############H
                         H
   X $  $       $     $X H
   X#######V######V####X H
                         H
     X  $    $    $  X   H
     X###V######V####X   H
                         H
      X  $     $  $X     H
     XX############X     H
                         H
                         H
$$$$  &          &    HX H
#########XXXXXX######XXX H