            |             
            |             
$           ||           $
H H----------|---------H H
#HH &                $ HH#
##H H------ ---------H H##
###HH $              HH###
###VH H------ -----H&HV###
###V#HH          $ HH#V###
###V##H H--- ----H H##V###
###V###HH $      HH###V###
###V####H H-- -H H####V###
###V#####HH    HH#####V###
###V######H    H######V###
###V#######H@$H#######V###
###&       H##H        ###