 -------$$######$$------- 
H      $###HHHH###$      H
H     $##HHH&&HHH##$     H
H     ##HH      HH##     H
H    $#HH        HH#$    H
H    ##H$        $H##    H
H    #HH$        $HH#    H
H    #H$$        $$H#    H
H    #HH$        $HH#    H
H    ##H$        $H##    H
H     #HH$      $HH#     H
H     #VHH$$  $$HHV#     H
H      V#HHH$$HHH#V      H
H       ###HHHH###       H
H@     &  ######  &      H
########H        H########