|           ##           |
|           XX           |
| $      $  ##  $      $ |
#X#X#X#X#X#HXXH#X#X#X#X#X#
   $    $  H##H  $    $   
H#X#X#X#X#X#X#X#X#X#X#X#XH
H   $  $    ##    $  $   H
#X#X#X#X#X#HXXH#X#X#X#X#X#
    $&&$   H##H   $&&$    
H#X#X#X#X#X#XX#X#X#X#X#X#H
H  $    $   ##   $    $  H
#X#X#X#X#X#HXXH#X#X#X#X#X#
  $      $ H##H $      $  
H#X#X#X#X#X#XX#X#X#X#X#X#H
H           @            H
#X#X#X#X#X#X#X#X#X#X#X#X#X