|        #################
|        ########X ------#
|   $  H#    $   XH # $  #
#######HX####### XH ######
   $   HX    $   XH ######
H######HX ##V### XH ######
H   &$  X      $ XH   &   
#######HX ##VVV# ########H
 $     HX    $           H
H#######X ##V###         H
H $     X      $         H
#######HX ##VVV#  #####  H
      $HX      $  #  $#  H
H#######X ##V###    H##  H
H  &      @         H# $ H
##########################