   --$ --------&----- ----
 $H $#$        H- # -H $$$
@H $# #$      H- ### -H $$
# $#   #$    H- #   # -H $
 &V  #  #   H- ##   ## -H&
H#  ###  XXX-   #$$$#   #H
H  #   #   $   HH###     H
H - ###   $H  H##H#      H
H  - #   $H   H$$H ------H
H   -   $H   HXXXXH      H
XXH  ---H    H$  $H -----H
  H         H######H     H
  H###H     H$    $H ----H
      H    HXXXXXXXXH    H
      H  & H$   &  $H ---H
#######XXXXX########H    H