 $       $         $    $ 
H##    H###    H#########H
H$   $ H     $ H $   $   H
H##H###H   #####X##X###X##
H  H  &H   -------------- 
###H######H      $  $&   H
   H      H X####XXXXX###H
   HXXXXX H X      $ $   H
   H  $ X H X   XXXXXXXX H
$$XXX###X H X   X  $$  X H
##XXX###X H X $ X H###HX H
 $  $     H XXVXX H   HX H
########  H X     H  &HX H
 $ $   X  H X#######XXXX H
#####H XXXX####X   $ $  @H
###$#H           H########