                          
 |                       |
 H#######################H
 H H##   $   $ & $   ##H H
 H###H###############H###H
 H H H ### $   $&##H H H H
 ##H###H H#######H H###H##
 H H H H H H###H H H H H H
 H###H###H H $ H H###H###H
$H H H H H&HXXXH&H H H H$H
###H###H$HXHXXXHXH$H###H##
#H H H HXHXHXXXHXHXH H H H
#H## HXHXHXHXXXHXHXHXH ##H
#H HXHXHXHXHXXXHXHXHXHXH H
#HXH H H H H  @H H H H HXH
###########H#$#H##########