XXXXXXXXXXXXX  | XXXXXXXXX
  &H    H---   | H      $ 
XXX|##XXX#V#XXX| HXXXX HX#
X--H     H----H  H   #####
X  H     $ #$#H& H  $   ##
$ VH     H    X#H XX####X#
X#VH-----H-----XH-------HX
#$ X     H   $HXXX      H#
XXV#  $$$H    HX----  $ HH
         H    HXH $   V#XH
###V#    H @  HXH        H
H---- HX##X##VXXH        H
H$   #H       H#H  X#### H
HX--###H      HXH  # $ X H
H  ###X#H &   H H   #XX#XX
#####XXXX#############X###