              XXXXXXXXXXX|
&        &    X  $ X     |
X------####H @X HX XHX###|
#####   $  ##XX HX XHX###|
    ######      HX XHX   |
##H      ###H $ HX XHX $ |
 ###X#H     H###XX XHX###|
  $  ##X#H  H    X XHX###|
####    ####H    X XHX   |
 $ #XH#    ##X##HX XHX$$ |
##   H##XX# $  XHX XHX###|
 #X##H    ##XX#XHX XHX###|
   ###X##H $   XHX XHX ##|
 H##   $###X#H#XHX XHX  #|
 H#          H $HX  H   $|
$H#X###X#####X##XX##X#####