H   -                H----
H    H               H X  
H    H           &   H X$$
H $  H###  $  $H####V#H###
H##  H  #########     HH#V
H    H                 HHV
H     H-----------------HH
H     H                  H
H     H$       & $      $H
H     ####HXXXXXXXXX##V###
H---      H         ---   
  &$      H        H      
########H H   $    H-   $ 
       #####HXXXH### #$###
$      @    H   H  & #####
############H   H#########