|#########################
|------------------------ 
|#XXX#XXX#XXX#XX#XH#X---#H
|#    $    $   $  H   $H#H
|$HXXXXXXXXXXXXXXXXXXXXHXH
|#H#----------------X $H#H
|$H# XXXXXXXXXXXXXXXXX###H
|#H# X $$$$$$$$$$$$   $#$H
|$H# X###XXXXXX#XXXXXH###H
|#H#     &           H$#$H
|$H#XXXXXXXXXXX##XXXXH# #H
|#H------------------  H#H
|#XX##XXHXX#X#XXHXXXXXXH$H
| &     H XX    H  &  $H#H
XXX#X###XXXXHXX#X#XX##XX#H
@           H            H