####################     |
 @##--- XX   $           |
 #X  $ HXX######HH H#H H |
 #     H    XX# HH$H H H |
 #H####X##$   # HH H H#H |
  H#      X##   HH H H H |
$ H#   $  #X# H# H H H H |
#HH##V#X###X# H#$#|##H#H |
#H      &     H#V#|# H H |
#H##X#######XHHH #|# H H |
#H #X#######XHH  #|# H H&H
 H  X  $    XH   #|#HH###H
 HH#X#######XH $ #|#H&   H
 #H#X#######XHXXX#|####  H
 #H#     $  XX#   |   #  H
 $H #XXXXXXXXX# & |   ####