#|####|#####|#####|#####|#
 |$&  |     |   $ | $   | 
H########V####V##########H
H#$       &$        $   #H
H#####V########V#######H#H
H#  $          $      #H#H
H#H####V####V#####V##H#H#H
H#H#                #H#H#H
H#H#H#$     &     $ #H#H#H
H#H#H###V##V###V#####H#H#H
H#H#H   $        $   H#H#H
H#H###V############V###H#H
H#H   $         $      H#H
H###V####V####V######V###H
H   &   $    @     $  &  H
##########################