######HH----------HH######
#####HH   -    -   HH#####
####HH     #&&#     HH####
###HH    - #### -    HH###
##HH    - ###### -    HH##
#HH----- ######## -----HH#
HH    - ####$$#### -    HH
H      ############      H
HH    - ####$$#### -    HH
#HH    - ######## -    HH#
##HH    - ###### -    HH##
###HH    - #### -    HH###
####HH    -    -    HH####
#####HH            HH#####
######HH&   @    &HH######
##########################