XXXXXXXXXXXXXXXXXXXXX|    
         &           |    
    H#X##XX#HX       |    
    H      |HX#X##XX#|    
 ##XH     H|H# # &#-------
$   H   $|H|## # X#      $
    H   H|H|#  #  #      &
H   H   H|H|# $#@ #      #
H   H   H|X##  ## #     $#
HXXXXV#XX|X     # #     ##
H --------X-----# #  $   #
H     $  H     ## #    ###
H  HXVXXXHXXX#H#  #   $#  
H  HX   XHX  #H####V#X# $ 
H  HX   XHX$ #H        ##X
H $HX & XHX#####XX###X####