H & #         ------------
H####       #H            
H####       #H #X#X#X#X#X#
H####       #H $ $ $ $ $ $
H##$#       #H#V#V#V#V#V#V
H#### $  &  #H#V#V#V#V#V#V
H############H------------
H############H   X X X X X
H  @ &       H   #V#V#V###
H#######H#######H     V###
H#######H  #####H####HV###
H#######H#$  ###H####HV###
H#######H###$  #H &  HV###
        H#####  H####HV###
    $ $ H#######H####HV###
################H $$ HV###