                          
     |||||||@|       |&   
   &    |    ||     ||X   
  $H$   |     ||   ||XXX  
 $HHH$  |      || ||XXXXX 
$HHHHH$ |       |||XXXXXXX
HHHHHHH |  $& $  |---HHH  
   H   ############   H   
  $X$  # $      $ #   H   
 $XXX$ # -------- #   H   
 XXXXX # H      H #   H   
  XXX  # H      H #   H   
H#####H#$H   &  H$#   H   
H     H############   H   
H     H H        H    H   
H#####H############H#####H