    |                     
    |            XXXXXXXXX
XXXX|XXXXXH----H          
    |     H @  H   &      
####H#####################
#H  H  H###    ####       
HH#####H### ## ###########
H###### H## $# ### ##  ## 
H# ### #H## ## ### $### $ 
H## $ ##H##    ### ## $## 
H#######H#########V#######
H  # #$ HH              &H
H####### H########H######H
H $###   H      ##H      H
H      & H   $  ##H   $  H
##########################