----$                $$@#|
    #H              H####|
    #H             HV####|
    #H            H#V#  #|
    #H           H##V#$ #|
$ & #H          H#$#V#VV#|
###  #H        H# H#V#  #|
$  #$ #H$     H# $H#V#  #|
##H #  ##H   H####H#V#  #|
$ #H #$ #H$&H# $ $H#V#  #|
#H #H #  ##H######H#V#  #|
$#H #H #$ #H $ $ -H#V#  #|
H #H #H # #H##### H#V#VV#|
#H #H #H          H#V#   |
 H  H  H     &    H      |
##########################