|                        |
|------------------------|
HH                      HH
H  #V##   ###V## ######  H
H  #  ##  #    # #    V  H
H  #   ## #      #       H
H  #    # #      #       H
H  #   $# #    $ #       H
H  #   ## #   ## #    $  H
H  #$ ##  #   $# #$  $#  H
H  ####   ###V## ##V###  H
H      @                 H
H H###### ###### #H####  H
H H#   $# ######H#H##$#  H
H&H#    #&## $##H H####  H
##########################