 --------#         &      
H        #  $   H###H # #H
H VVVVVV ####HX HX  H # #H
H VVVVVV #  $HX HXHXH # #H
H VVVVVV #H###X HXHXH # #H
H VV$$VV #H $ X HXHXH # #H
H VVVVVV ####HX HXHXH # #H
H VVVVVV #  $HX HXHXH #$#H
H       &#H###X HXHXH ##VH
H#########H $ X HXHXH    H
H############HX##XHX#####H
H#########  $HXXXXHXXX###H
H##$$#####H###X $ |$ X$##H
H########$HX#XXXXXXXXX###H
HXXXXXXXXXX      $ &$    H
H @        H##############