|#XXX#XX##X##XX#X XX#XX##X
H|||||X|X#XX#|X||||||XX###
H @ $|X| $$$ | |  & | $  |
HX#X#|X|#X##XH#HX###H####|
H $  |X| $$$ H H $##H###X|
HX#X||X| ### H H XX$H$##$|
H||| $X|     H$H  #XHX#XX|
H   ##X|  $  HXH  $ H----|
H$ &| X| ### HXH  #XH  $X#
H####HX|  #  H$H  # H ##$|
H  X HX||||||HXH  # H   XH
H  X H---------H$&# HX$$$H
H  X$HX####H $XH##########
H  X#HX   #####X#X-------H
H $  H  $   $       & $$$H
######X#XXXXXXXXXXXX#XXXXH