                      |   
              $    #&#|#  
      H--H########## #|#  
$ ----H   #      $ # #|#  
#H        #    ##### #|#  
##H     & #    $     #|#  
###H    $ #     ---- #|#  
####H ----#$  $#   H  |   
XXXXXXH   ######   H--|   
      H   ######   H #####
      H   ######   H #$ & 
      H   ######   H ####H
      H            H     H
    --H            H     H
& $#  H      @     H     H
####  H##$#########H  ###H