  |                       
  |                       
  |      -----      -----H
 &H    -      H --&H     H
V#H---H #V##  H#  #H ##V##
V#    H##V### H#  #H ##V# 
V#    H##&-   H#  #H ##   
V#    H##H ## H#  #H- #   
V# $  H##H$## H#$ #$HVV$@ 
V --H-H##H ## H#  # H#### 
## HH  ##H  # H#  # H#### 
##HH   ##H V -H#  # H##   
##H    ##H ##  #  # H##   
##H $--##H  $  # $# H   $ 
#####H ######H ##V# H####H
#####H $#### H $#V$ H#####