 -  &   ### &  $   ###    
H H####H###H###### ######H
H H####H  $H###$## ###$##H
H H#$$#H##########   ####H
H #####H    -------------H
H     #H&       $  $      
H#V#H #H####V#######H$ $  
H$ #H #H---- -----HXXXXXXX
## #H #H   $ $    H @$  $ 
   $H #H####V#####H######H
##HXX #H----------H      H
##H   $H   $     X#####H H
##H#############|X   $ H H
$#H#            |X####V# H
##H#     $   $  |X   &   H
##########################