  ---     $ $    ---  X #H
##  #H   H###H  H&  ##X  H
 ## #H  H#########H ##X #H
##  #H####$#$#####H #$X##H
$##$#H    &       H     #H
###############V#########H
   $ &  $         @   &  H
XXXXXXXXXXXXXXH###########
 ----------- XH           
H     -     HXH---------- 
H    - -    HX## ## ## ##H
H   - # -   HXXXXXXXXXXXXH
H  - ### -  H------------H
H - ##### - HV#V#V#V#V#V#V
H- ##$$$## -HX            
H ######### HX        &   