---------   H      -----  
         H   H    H       
   ------H $  H   H       
  H $ &  ###  H    H      
  H ####     H ---  H $$--
  H         H   $   H ##  
  H---   $ H    X  H     $
      H ## H      H      #
      H     H     XXX###X#
      H      H --         
  $&$ H       H        X X
  ### H----   H   XXXXXX X
$       $$   H $     $ $&X
X       XX  H  #  ########
          @ H             
####XXX#########XXX#######