###XX####################|
 $  X     $  &    @     #|
H#H X#V#H######V####### #|
H##H  V#HH##$--------$  #|
H ##H V##HH##$   $  $##H#|
H  ##H ###HH##$    $## H#|
HH  ##H ##HHH##$  $##  HH|
HHH$ #HH #H#HH##  ##  #HH|
HHHH  H#H H##HH#V##  #HH#|
$HHHH&H##HH###HHV# $HHH$#|
HH$  HH ##H ###HV  #HHHH#|
##H####$ ##H ##H  HHHH&H#|
HHHHHHHH  #HH HH&HHH$  H#|
H HH $  H  H#HHH#HH####H#|
$ H#H####H     HHH$    H |
####HHHH$H#####HH#########