HH #####&HXX XXH&##### HHX
HXHH $ HHXHHHHHXHH $ HHXHH
$HXH#H#HXH$#H#$HXH#H#HXH$#
# HXHHHXH # H # HXHHHXH #H
 #HHXHXHH# H H #HHXHXHH#  
H# HHHHH #H # H# HHHHH #H#
H#H     H#H#$#H#H     H#H@
H# HHHHH #H # H# HHHHH #H#
 #HHXHXHH# H H #HHXHXHH#  
V HXHHHXH # H # HXHHHXH #H
$HXH#H#HXH$#H#$HXH#H#HXH$#
HXHH $ HHXHHHHHXHH $ HHXHH
XH ##### HXXHXXH ##### HXX
XH H $ H HXXHXXH H $ H HXX
XH H#H#H&HHXHXHH&H#H#H HXX
HXHXHHHXHXHHHHHXHXHHHXHXHH