      --          --    - 
 #####$-H########H-$####$ 
 ######$H########H$###### 
 #######H########H####### 
 ## ####H###     H###   # 
 ##  ###H###$$$  H###$$$- 
 ##  ###H######  H######$ 
 ##  ###H######  H ###### 
 ##  ###H######  H  ##### 
 ## $###H###     H     ## 
 ##$####H###$$$$$H##$$$## 
 #######H########H##V#### 
 ###### H########H #V#### 
 #####  H########H  V###  
 &  &   H   @    H   &  & 
########|###HH###|########