#|#X#X#X#X#XX# #|#X ##|###
#|######X#XXHX X|X# # |  H
X|      #X  H   | $  &|  H
##V##H------H##V#########H
@ $  H$H#X$ H X  X#X  #  H
####H##HX#X  $ X    X ---H
 X# HX HXXX#XX# X  -----#H
 &  H  H  #---------X $##H
VX##H  H$XX#$ #X$  X  ## H
V X H  $X#XX#$ X#---H#   H
 #  H $X $$$ X$  X  H    H
----H$X H#X#  X$   #H#####
 H  XX--H      X  $ H XXXX
 H#X#$$ H--H  H ####H  X  
 H$ $##$&$$H--H  ##XH   &$
###########H $H$##########