           ##            |
    $ & $  XX     $&  $  |
H############H############
H--------- XXH            
          H##H  --------- 
 ---------HXXH$          H
H $  ---@  #####       $H#
#####   #H XXXXX    &$H###
  - #   #H #####   $H#####
##$H#   #H XXXXX $H#######
$##H#   #H---- $H#########
##$H#   #H XX HXXXXXXXXXXX
$##H#$$ #H ## H           
##$H###V#H XX H##########H
$##H &   H$##$H#$        H
###########XX###XXXXXXXXXX