           |              
           |              
        H  |            H 
   #####H  H------------H 
   # $ #H  H          & H 
   #   #H  HXXXXXX##XX##XX
X#XX#X#XX#XH#-----#V###  #
 $& $    $ H# H   #-- #  #
######V####H# H#$$#$#H#$ #
 ----------H# H####V#H#  #
H&         H# H$   --HHH##
H##########H######H $  H  
H         @H      H##  HHH
H$#### $ ##H## $ #H#$--  H
H## $#####$H$#####H##$ ##H
##################H  #####