|                         
|      &          $       
| XXHXXXX         XXXHXXXX
|   H    #$      #   H# --
|---H-----#     #----HXH $
#$  H  $   #   #     H#H- 
 #& H--- #H # #   $  HX  H
  #     # H  V       H#$ H
@  #   #  H          HX -H
XX# # #   H# ----- $ H#H  
    #V    H # $    # HXH& 
$H###     H  #    # $H###H
#HX-------H   #  #  #H###H
 H             VV    H   H
 H                   H   H
XXXXXX#######XXXX####XXXXX