              |           
   --------  -|---        
  H        H-     H H##H  
  H-------&H------ H#H-#H 
  H       H#  --- H# H$ VH
  H      HV #H   H#  H  $#
  H  -- H#   #H - @--H---#
H #HH| H#$H## #H  #      #
H# #H| H#######H  ### ####
##V##| H#  #$ #H-H   -  &H
##V##| H#######  H### ###H
# $ #| H# $#  #H H#$# ###H
#####| H#######H H### #$#H
#####| H#  #$  H H#   #  H
#   #| H#######H H#V###V#H
# $  |#H      #H#H  #  $ H