|                        |
|                        |
|----H     H------H#    #H
     H-----H      H# $  #H
 $   H     H & $  H####V#H
###$ #HH   ############V#H
###### H $          $    H
####$  H##   $#$   ##    H
#####$ H##  $###$  ##    H
######$H## $#####$ ## &$ H
#######H##V###########HX#H
#     &H              H #H
#  $ ##H       @      H #H
#######H----H####H$---H #H
#  $   H  $ H##$#H#  #H$#H
#################H####H##H