      |                  |
      |      &           |
--- & |------#####H      |
H##X### #######H$########H
H##$### X$   H#H##   $ $ H
H###### XXXXXHXH   ----- H
H        ----H H   H     H
##V###H        H   H  #  H
---   H###### #######H####
$   H##     ----# HHHHHH--
    H#  XXXH    #$HHHHHH $
H####  #   XXXH #-HHHHHH -
H     #  H####H #$HHHHHH  
H   H#   H####H #-HHHHHH  
H@  H#H  H# $#H #########H
###############          H