H                         
H  --     ----------------
H   |    $H    $    H   &H
### ######H-------H H HXXX
 $        H $     H H H   
XXXH###&  H-------H H XXXH
   H $ ####    $  H H    H
 @ H ####$#-------H H HXXX
H# H--------------H H H $ 
H######V#####   &   H XXXH
H$  ###     #$  ####H    H
H############XX ######H###
HX###########   ######H##$
HX###########HX ##$###H###
HX $#########HX       H   
H ######$    HX###########