|                         
|-------------------------
|       V###H###V         
|    $V#V   H   V## $     
|  $V#V$$$$$H$$&$$#V# $   
| ##V#V#####H######V#V# $ 
###         H         #V#V
#     $$$$  H& $$$$     #V
    H######VH#######H     
    H       H       H     
   $H  $$$$$H $ $$$$H &   
 HV#########HV#########H  
 H          H          H  
 H          H          H  
 H          H  @       H  
##########################