-------------H------------
 $      $    H   $   $&$ $
&$  $    & $ H $   $ $    
 #V##V#H H#V####H H#V#    
 #V##V##HH#V####VHH#V#    
 #V##V##VH#V####V#H#V#    
 #V#  ##VH#V#  #V#H#V#    
 #V#  ##VH#V#  #V#H#V#    
 #V#  ##VH#V#  #V#H#V#    
 #V#  ##VH#V#  #V#H#V#    
 #V# $##VH#V# $#V#H#V#    
 #V#V###VH#V#V##V#H#V##V# 
 #V#V### H#V#V##V H#V##V# 
 #V#V##  H#V#V##  H#V##V# 
         H   @    H       
##########################