      |                   
      |                   
      |   HXXXXXXXXXXXXXXX
#HH###H###H     &  -------
$#H# #H# #H############ $ 
 #H#$#H#$#HHHH$HHHH$HHH##H
VHH###H# #HHXXXXHHXXXHH $H
HHHHHHHHHHHHX  $HHX  HH##H
H    H ## HHX -XHHX $HH# H
H ###H #$#HHXXXXHHXXXHH#H 
H #$ H  ##HH---- HHHHHH#H$
H ## H # #H  $   HHHHH###H
H    H@## H#######  $H###H
HHHHHHXXXXH#HHHHHX ##H###H
H    $  XXH#H H HX ##H ##H
####H   &  #H H$HX  $H# &H