            |             
            |             
          & |  $--        
 --------HXXX#V## H       
H        H      $ H       
H      #####XXX######     
H      #$ #  #   #  #     
H & $$ #  # $# $$#$$# $   
H#######  ##############  
H#  # #####    #          
H# $# $  #  H$ # @    $   
H##########XHX#####V##### 
H           H        ---  
H           H       H  $  
H        $  H       H ### 
############H   $&  H  $  