---------        ---------
H        ########        H
H      ############      H
H   & ############## &   H
H XXX################XXX H
H       ##########       H
H XH       ####       HX H
XXXH                  HXXX
   H $  $  $  $  $  $ H   
   H                  H   
   H       ####       H   
   H    ###VVVV###  @ H   
   H ###VVVVVVVVVV### H   
   H  VVVVVVVVVVVVVV  H   
   H   VVVVVVVVVVVV   H   
   H     VVVVVVVV     H   