########|#################
@ X  XXX|   XH #   H----- 
#H   H XHXX XH$#HXXH      
$HXX#H XHXX  H  H        $
##H  H XH  ###HXH-----    
$XH##X$XH##---HXH       ##
  H    XHX $X HX##   $    
 &H  $ XHX####HX H      & 
XX##H# XHX    H--HXXXXXXXX
H  XH#  HX###### H   X----
H#  H###HX $#$  ###H X    
HX HXX XHX  #      H      
HX HX $XH   ###########HX 
H ### XXHX###          H  
H    &  HX$ XH $    $  H  
#########X##$HXX####XXXH $