                          
     ---|      ---    -   
H   H  -#XXXXXX   #### XXH
H$  H$  #   X$           H
##H-XXH XH  XX#X VVVV## HV
 $H &$H XH  X$          H 
H##-HXX XHH XX#H V    V H 
H$  H$  X HH  XH  #$$#  H 
##H-XXH X  HH XH   ##H--H$
&$H  $H X   HHXH     H  #V
H##-HXX X    HXH  &  H    
H$  H$& X     XHXXXXXXXXH$
##H-XXH X     XH#  $ $ #HV
 $H  $H X     XH#H#X#X##H 
H##-XXX X&$$H# H#H $ $  H 
H @     ######XX##X#X#X#X#