              |           
 &        -@  |     -     
 HH      H H  |    H H   H
H$H     H   H |   H   H  H
 #HH   H #$# H|  H #$# H-H
 #H ---H&### H---H&#H#   H
X#H#V##X##X##X##V##XH#V##H
# H V  #  $###  $# #H V  H
#-H-V--# H#----H----H-#--H
# H V  # H#  # HVH #& $  H
#VHX#VX##H##X##XVHX##X#V#H
 V##   ##H##   #VH##   V#H
  H-- --#H#-- --VH#-- --#H
  H  $  #H#  $  #H   $  #H
 $H  X  #H#  X  #H#  X  #H
#VHV#X## H ##X## H ##X#V H