         && || &&         
        $$$|##|$$$        
  $$$$$|XXXXXXXXXX|$$$$$  
 |######          ######| 
 |||                  ||| 
   |                  |   
   |                  |   
   |                  |   
   |                  |   
   |                  |   
   |                  |   
   |                  |   
   |                  |   
   |                  |   
   |           @      |   
#######X#####XX#####X#####