                          
        H##    ##H        
       H##      ##H       
      H##        ##H      
     H##$  &     $##H     
 $--H################H--$&
H#H   ##$        $##   H#H
HH#H   ## $    $ ##   H#HH
$HH#H&  ####  ####   H#HH$
 $HH#H   ###  ###   H#HH$ 
  $HH#H   ##$@##   H#HH$  
   $HH#H   ####   H#HH$   
    $HH#H   HH   H#HH$    
     $HH#H  HH  H#HH$     
$ &   $H##H HH H##H$   & $
##########################